3 4 6 6 6 6 6 6 4 3
3 4 5 6 6 6 6 5 4 3
3 4 5 5 6 6 5 5 4 3
3 4 4 4 4 4 4 4 4 3
3 3 3 3 3 3 3 3 3 3

res/textures/level-3-background.png